NO data/textures/colorstone.xpm
SO data/textures/colorstone.xpm

WE data/textures/colorstone.xpm

EA data/textures/colorstone.xpm
F 0,32,32





C 32,32,32

11
1
11111111111111111111111111111111111
100000000010000000000000000000000001
100000000010000000000000000000000001  1
1000000111000000000000000000000000001
1000E0000000000000000000000000000001
10000001110000000000000000000000001
100000000000000000000000000000000001
100000000000000000000000000000000001
111111000111111111111111111111111111
11111101111							1
1 000000011							1
11111111111							1