NO data/textures/Dungeon_brick_wall_blue.png
SO ../project/data/textures/Dungeon_brick_wall_blue.png
WE data/textures/Dungeon_brick_wall_blue.png
EA data/textures/Dungeon_brick_wall_blue.png

F 255,30,4
C 200,30,4

    11111
11110001
10000111
111N01111
1 1111111
1111