SO data/textures/redbrick.xpm
NO data/textures/greystone.xpm
WE data/textures/bluestone.xpm







EA data/textures/colorstone.xpm

F 0,79,79
C 47,79,100

111111111111111111111111111111111111111111111111111111111111111111111111111111111111111111111111111111111111111111111111111111111111
100001000000000000000000000000000000000000000000000000000000000000000000000011110000000000000000000000000000000000000000000000000001
100001000000000000000000000000000000000000000000000000000000000000000000000011110000000000000000000000000000000000000000000000000001
100001000000000000000000000000000000000000000000000000000000000000000000000011110000000000000000000000000000000000000000000000000001
100001000000000000000000000000000000000000000000000000000000000000000000000011110000000000000000000000000000000000000000000000000001
100001000000000000000000000000000000000000000000000000000000000000000000000011110000000000000000000000000000000000000000000000000001
100001000000000000000000000000000000000000000000000000000000000000000000000011110000000000000000000000000000000000000000000000000001
100001000000000000000000000000000000000000000000000000000000000000000000000011110000000000000000000000000000000000000000000000000001
100001000000000000000000000000000000000000000000000000000000000000000000000011110000000000000000000000000000000000000000000000000001
100001000000000000000000000000000000000000000000000000000000000000000000000011110000000000000000000000000000000000000000000000000001
100001000000000000000000000000000000000000000000000000000000000000000000000011110000000000000000000000000000000000000000000000000001
100001000000000000000000000000000000000000000000000000000000000000000000000011110000000000000000000000000000000000000000000000000001
100001000000000000000000000000000000000000000000000000000000000000000000000011110000000000000000000000000000000000000000000000000001
100001000000000000000000000000000000000000000000000000000000000000000000000011110000000000000000000000000000000000000000000000000001
100001000000000000000000000000000000000000000000000000000000000000000000000011110000000000000000000000000000000000000000000000000001
100001000000000000000000000000000000000000000000000000000000000000000000000011110000000000000000000000000000000000000000000000000001
100001000000000000000000000000000000000000000000000000000000000000000000000011110000000000000000000000000000000000000000000000000001
100001000000000000000000000000000000000000000000000000000000000000000000000011110000000000000000000000000000000000000000000000000001
100001000000000000000000000000000000000000000000000000000000000000000000000011110000000000000000000000000000000000000000000000000001
100001000000000000000000000000000000000000000000000000000000000000000000000011110000000000000000000000000000000000000000000000000001
100000000000000000000000000000000000000000000011111000000000000111100000000000000001100000101010101111100000000000000000000000000001
110000000110000000000000000000000000000000000000000000000000000000000000000000000000000000000000000000000000000000000000000111111001
100001000000000000000000000000000000000000000000000000000000000000000000000011110000000000000000000000000000000000000000000000000001
100000000010000000000000000000000000000000000000000000000000000000000000011111111111110001111111111111111111110000000000000000000001
100001000000000000000000000000000000000000000000000000000000000000000000000011110000000000000000000000000000000000000000000000000001
100001000000000000000000000000000000000000000000000000000000000000000000000011110000000000000000000000000000000000000000000000000001
100001000000000000000000000000000000000000000000000000000000000000000000000011110000000000000000000000000000000000000000000000000001
100001000000000000000000000000000000000000000000000000000000000000000000000011110000000000000000000000000000000000000000000000000001
100001000010000000000000000000000000000000000000000000000000000000000000000000000000000000000000000000011000000001100000000000000001
100001000010000000000000000000000000000000000000000000000000000000000000000000000000000000000000000000011000000001100000000000000001
100001000010000000000000000000000000000000000000000000000000000000000000000000000000000000000000000000011000000001100000000000000001
100001000010000000000000000000000000000000000000100000000000000000000000000000000000000000000000000000011000000001100000000000000001
100001000010000000000000000000000000000000000000000000000011000000000000000000000000000000000000000000011000000001100000000000000001
100001000010000000000000000000000000000000000000000000000000000000000000000000000000000000000000000000011000000001100000000000000001
100001000010000000000000000000000000000000000000000000000000000000000000000000000000000000000000000000011000000001100000000000000001
100001000010000000000000000000000000000000000000000000000000000000000000000000000000000000000000000000011000000001100000000000000001
100000000010000000000000000000000000000000000000000000000000000000000000011111111111100000011111111111111111110000000000000000000001
100000000010000000000000000000000000000000000000000000000000000000000000011111111111100000011111111111111111110000000000000000000001
100000000010000000000000000000000000000000000000000000000000000000000000011111111111100000011111111111111111110000000000000000000001
100000000010000000000000000000000000000000000000000000000000000000000000011111111111100000011111111111111111110000000000000000000001
100000000010000000000000000000000000000000000000000000000000000000000000011111111111100100011111111111111111110000000000000000000001
100000000010000000000000000000000000000000000000000000000000000000000000011111111111100N00011111111111111111110000000000000000000001
100001000010000000000000000000000000000000000000000000000000000000000000000000000000000000000000000000011000000001100000000000000001
100001000010000000000000000000000000000000000000000000000000000000000000000000000000000000000000000000011000000001100000000000000001
100001000010000000000000000000000000000000000000000000000000000000000000000000000000000000000000000000011000000001100000000000000001
100001000010000000000000000000000000000000000000000000000000000000000000000000000000000000000000000000011000000001100000000000000001
100001000010000000000000000000000000000000000000000000000000000000000000000000000000000000000000000000011000000001100000000000000001
100001000010000000000000000000000000000000000000000000000000000000000000000000000000000000000000000000011000000001100000000000000001
100001000010000000000000000000000000000000000000000000000000000000000000000000000000000000000000000000011000000001100000000000000001
100001000010000000000000000000000000000000000000000000000000000000000000000000000000000000000000000000011000000001100000000000000001
100001000010000000000000000000000000000000000000000000000000000000000000000000000000000000000000000000011000000001100000000000000001
100001000010000000000000000000000000000000000000000000000000000000000000000000000000000000000000000000011000000001100000000000000001
100001000010000000000000000000000000000000000000000000000000000000000000000000000000000000000000000000011000000001100000000000000001
100001000010000000000000000000000000000000000000000000000000000000000000000000000000000000000000000000011000000001100000000000000001
100001000010000000000000000000000000000000000000000000000000000000000000000000000000000000000000000000011000000001100000000000000001
100001000010000000000000000000000000000000000000000000000011000000000000000000000000000000000000000000011000000001100000000000000001
100001000010000000000000000000000000000000000000000000000011000000000000000000000000000000000000000000011000000001100000000000000001
100001000010000000000000000000000000000000000000000000000011000000000000000000000000000000000000000000011000000001100000000000000001
100001000010000000000000000000000001000000000000000000000000000000000000000000000000000000000000000000011000000001100000000000000001
100001000010000000000000000000000000000000000000000000000000000110000000000000000000000000000000000000011000000001100000000000000001
100001000010000000000000000000000000000000000111000000000000000110000000000000000000000000000000000000011000000001100000000000000001
100001000010000000000000000000000000000000000111000000000000000110000000000000000000000000000000000000011000000001100000000000000001
100001000010000000000000000000000000000000000111000000000000000000000000000000000000000000000000000000011000000001100000000000000001
100001000010000000000010000000000000000000000000000000000000000000000000000000000000000000000000000000011000000001100000000000000001
100001000010000000000000000000000000000000000000000000000000000000000000000000000000000000000000000000011000000001100000000000000001
100001000010000000000000000000000000000000000000000000000000000000000000000000000000000000000000000000011000000001100000000000000001
111111111111111111111111111111111111111111111111111111111111111111111111111111111111111111111111111111111111111111111111111111111111