NO data/textures/greystone.xpm
SO ../project/data/textures/redbrick.xpm
WE data/textures/bluestone.xpm
EA data/textures/colorstone.xpm

F 255,30,4
C 200,30,4

111110
100010
100010
100N10
111110
000000