NO data/textures/Dungeon_brick_wall_blue.png
SO ../project/data/textures/Dungeon_brick_wall_blue.png
WE data/textures/Dungeon_brick_wall_blue.png
EA data/textures/Dungeon_brick_wall_blue.png

F 255,30,4
C 200,30,4

00111
10001
1S001
100N1
11111