NO data/textures/colorstone.xpm
SO data/textures/colorstone.xpm
WE data/textures/colorstone.xpm
EA data/textures/colorstone.xpm

F 0,32,32
C 32,32

1111111111111
100000N000001
1000000000001
1111111111111