NO data/textures/greystone.xpm
SO ../project/data/textures/redbrick.xpm
WE data/textures/bluestone.xpm
EA data/textures/colorstone.xpm

F ,,,,255,,30,4
C 120,30,4

1111111111
10000N0001
1111111111