NO data/textures/colorstone.xpm
SO data/textures/colorstone.xpm
WE data/textures/colorstone.xpm
EA data/textures/colorstone.xpm

F 0,32,32
C 32,32,32

1111111111111
1N00000000001
10000000000N1
1111111111111
