NO data/textures/Dungeon_brick_wall_blue.png
SO data/textures/Dungeon_brick_wall_blue.png
WE data/textures/Dungeon_brick_wall_blue.png
EA data/textures/Dungeon_brick_wall_blue.png

F 255,30,4
C 200,30,4

1111111111111111111111111
        1000000000110000000000001
        1011000001110000000000001
        10010000000000000000000011111111
        111111111011000001010000000000001
        100000000011000001010111111111111
111101111111110111000000100011
11110111111111011101010010001
11000000110101011100000010001
10000000000000001100000010001
10000000000000001101010010001
11000001110101011111011110N0111
11110111 1110101 101111010001
11111111 1111111 111111111111