NO data/textures/greystone.xpm
SO data/textures/greystone.xpm
WE data/textures/greystone.xpm
EA data/textures/greystone.xpm

F 255,30,4
C 200,30,4

11111
10001
10001
10001
11111