NO data/textures/colorstone.xpm
SO data/textures/colorstone.xpm

WE data/textures/colorstone.xpm

EA data/textures/colorstone.xpm
F 0,32,32





C 32,32,32



111111111111111111111111111111111111
100000000010000000000000000000000001
100000000010000000000000000000000001
100000011100000000000000000100000001
1000N0000000000000000000001 10000001
100000011100000000000000000010000001
100000000000000000000000000000000001
100000000000000000000000000000000001
111111111111111111111111111111111111